#China
GHC = "countries/GreatHan.txt"
GSC = "countries/GreatSong.txt"
GYA = "countries/Guiyang.txt"
HGH = "countries/Honghe.txt"
YNN = "countries/Yunnan.txt"
GNN = "countries/Guangnan.txt"
LNS = "countries/Liangshan.txt"
SKY = "countries/Sakya.txt"
HEI = "countries/Heinan.txt"
CTO = "countries/Canton.txt"
ZHJ = "countries/Zhanjiang.txt"
XZH = "countries/Xuanzheng.txt"

#Korea
BHH = "countries/Sanggyeong.txt"
HWY = "countries/Hwaryeong.txt"
SLA = "countries/Gyeongju.txt"
JEJ = "countries/Jeju.txt"

#Northern Hordes
TMD = "countries/Tumed.txt"
DGH = "countries/Dughat.txt"
UKI = "countries/Uriankhai.txt"
YNI = "countries/Yenisei.txt"
MGH = "countries/Moghulstan.txt"
SJI = "countries/NanJin.txt"
DBT = "countries/Dorbet.txt"
ULG = "countries/UlaGorlos.txt"
SKH = "countries/Sakhalin.txt"
AMU = "countries/Amur.txt"

#Central Asia
BLK = "countries/Balkh.txt"


#French
REI = "countries/Reims.txt"
LAO = "countries/Laons.txt"
LGR = "countries/Langres.txt"
BVS = "countries/Beauvais.txt"
CLN = "countries/Chalons.txt"
NYN = "countries/Noyon.txt"
MNE = "countries/Maine.txt"
ANJ = "countries/Anjou.txt"
PTO = "countries/Poitou.txt"
BLS = "countries/Blois.txt"
LMC = "countries/LaMarche.txt"
AGM = "countries/Angoulme.txt"
ATS = "countries/Artois.txt"
FBR = "countries/FreeBurgundy.txt"
BRN = "countries/Bearn.txt"
PID = "countries/Perigord.txt"
LMN = "countries/Limousin.txt"
CNL = "countries/ChannelIslands.txt"
ORA = "countries/Orange.txt"
TUL = "countries/Toul.txt"
VDN = "countries/Verdun.txt"
MTZ = "countries/Metz.txt"
OCT = "countries/Occitania.txt"

#Low Countries
HLM = "countries/Haarlem.txt"
DHG = "countries/Amsterdam.txt"
VLG = "countries/Zeeland.txt"
ATP = "countries/Antwerp.txt"
GHE = "countries/Ghent.txt"
DKK = "countries/Dunkirk.txt"
ARH = "countries/Arnhem.txt"
BRD = "countries/Breda.txt"
LER = "countries/Lier.txt"
TLB = "countries/Tilburg.txt"
EHV = "countries/Eindhoven.txt"
BGG = "countries/Brugges.txt"
BSS = "countries/Brussels.txt"

#Germany
MRN = "countries/Merania.txt"
BGU = "countries/Burgau.txt"
KRN = "countries/Karnten.txt"
LBG = "countries/Lowerburgundy.txt"
HHH = "countries/Hohenlohe.txt"
ZHR = "countries/Zahringen.txt"
JLH = "countries/Julich.txt"
HDL = "countries/Hildesheim.txt"
CMM = "countries/Cammin.txt"
PMR = "countries/Pomerelia.txt"

#Antipapacy
ANP = "countries/Antipapacy.txt"

#Antipapacy 2

#Britain
YRK = "countries/York.txt"
OXF = "countries/Oxford.txt"
DRM = "countries/Durham.txt"
LCS = "countries/Lancaster.txt"
CHS = "countries/Chester.txt"
PEM = "countries/Pembroke.txt"
GLM = "countries/Glamorgan.txt"
PWY = "countries/Powys.txt"
SHP = "countries/Shropshire.txt"
KNT = "countries/Kent.txt"
WGT = "countries/Wight.txt"
WRF = "countries/Waterford.txt"

#Iberian
CBD = "countries/Cordoba.txt"
SEV = "countries/Sevilla.txt"
BJZ = "countries/Badajoz.txt"
ADR = "countries/Andorra.txt"
CMS = "countries/CoutoMisto.txt"
IBF = "countries/IberianFed.txt"


#Eastern Europe
BLH = "countries/BlueHorde.txt"
RDH = "countries/RedHorde.txt"
CSA = "countries/Csak.txt"
AAB = "countries/Aba.txt"
KSZ = "countries/Koszegis.txt"
KNN = "countries/Kan.txt"
JAA = "countries/Joannites.txt"
SLT = "countries/Split.txt"
PRI = "countries/Pristina.txt"
VEL = "countries/Velbazhad.txt"
HAL = "countries/Halych.txt"
DRK = "countries/Drutsk.txt"
NVL = "countries/Novosil.txt"
UDM = "countries/Udmurtia.txt"
MRV = "countries/Mordvins.txt"
MMR = "countries/Mari.txt"
MRM = "countries/Murom.txt"
MSK = "countries/Mosalsk.txt"
KUS = "countries/Kursk.txt"

#Baltics/Scandanavia
COP = "countries/Copenhagen.txt"
HLS = "countries/HolsteinButForReal.txt"
NJL = "countries/NorthJutland.txt"
JTL = "countries/Jutland.txt"
FYN = "countries/Fyn.txt"
LOL = "countries/Lolland.txt"
SJA = "countries/Sjaeland.txt"
SCN = "countries/Scania.txt"
HLD = "countries/Halland.txt"
BRO = "countries/Bornholm.txt"
SVO = "countries/Savonia.txt"
BGN = "countries/Bergen.txt"

POG = "countries/Pogesania.txt"
WRM = "countries/Warmia.txt"
SBI = "countries/Sambia.txt"
LTV = "countries/Latvia.txt"
BLT = "countries/Baltic.txt"

#East Indochinese

TMM = "countries/Sithammarat.txt"
PGN = "countries/Pagan.txt"
NST = "countries/Nusantara.txt"
KMI = "countries/Kalimantan.txt"
PTC = "countries/Petchaburi.txt"
RTC = "countries/Ratchaburi.txt"
SDH = "countries/Sadhuim.txt"
LPB = "countries/Lopburi.txt"
MGT = "countries/MuangThai.txt"
SYM = "countries/Syyam.txt"
PMN = "countries/MaeNam.txt"
ANK = "countries/Angkor.txt"

#Maritime SEA

BDU = "countries/Badau.txt"
GGG = "countries/Gangganegara.txt"
CHN = "countries/Chermin.txt"
NIS = "countries/Nias.txt"
MTW = "countries/Mentawai.txt"
MLY = "countries/Melayu.txt"

KDI = "countries/Kediri.txt"
TGJ = "countries/Tanjungpura.txt"
SOP = "countries/Soppeng.txt"
MMJ = "countries/Mamuju.txt"
SIG = "countries/Sigi.txt"
GOR = "countries/Gorontalo.txt"
MND = "countries/Manado.txt"
KNW = "countries/Konawe.txt"
BGI = "countries/Benggai.txt"

#Burma
BMA = "countries/Burma.txt"


#East Africa
AGW = "countries/Agew.txt"
SLM = "countries/Solomon.txt"
ZGW = "countries/Zagwe.txt"
#AKS = "countries/Aksum.txt"
IFT = "countries/Ifat.txt"
BAE = "countries/Bale.txt"
#AUA = "countries/Ausa.txt"
HRA = "countries/Harla.txt"
ABH = "countries/AlHabash.txt"
BRL = "countries/BetaIsrael.txt"
DJJ = "countries/Daju.txt"
NBA = "countries/Nuba.txt"
SHG = "countries/Shaigiya.txt"
JLI = "countries/Jaalin.txt"
SOB = "countries/Soba.txt"
SHI = "countries/Shendi.txt"
FZG = "countries/Fazughli.txt"
BTA = "countries/Butana.txt"
SKI = "countries/Suakin.txt"
ZNJ = "countries/Zanj.txt"
ZNZ = "countries/Zanzibar.txt"
MOZ = "countries/Mozambique.txt"
SIH = "countries/SwahiliMR.txt"

#Japan
NTT = "countries/Nitta.txt"
BFK = "countries/Bakufu.txt"

#East Siberia
KYK = "countries/Koryak.txt"
KEK = "countries/Kerek.txt"
KLY = "countries/Kolyma.txt"
KKK = "countries/Kamchatka.txt"
LMU = "countries/Lamutia.txt"
YTK = "countries/Sakha.txt"


#West Africa
TKR = "countries/Tekrur.txt"
OAG = "countries/Ouagadougou.txt"
TND = "countries/Tenkodogo.txt"
KNM = "countries/Kanem.txt"
GAO = "countries/Gao.txt"
ZMA = "countries/Zarmeganda.txt"
JUK = "countries/Jukun.txt"
FNG = "countries/Fadangourma.txt"
DEN = "countries/Denkyira.txt"	
YRE = "countries/Yoruba.txt"
TUJ = "countries/Tunjur.txt"
LGB = "countries/Ligbe.txt"
MNK = "countries/Mankessim.txt"
AKW = "countries/Akwamu.txt"
BEE = "countries/Bete.txt"
EHO = "countries/Ehotile.txt"
KRU = "countries/Kru.txt"
BAO = "countries/Baole.txt"
VAI = "countries/Vai.txt"
TEE = "countries/Temne.txt"
LMA = "countries/Loma.txt"
YKB = "countries/Yokuba.txt"
SNT = "countries/Asante.txt"
SNF = "countries/Senufo.txt"
TBI = "countries/Tibiri.txt"
DAA = "countries/Daura.txt"
KTG = "countries/Katagum.txt"
BIR = "countries/Biram.txt"
RNO = "countries/Rano.txt"
GBI = "countries/Gobir.txt"
ZHI = "countries/Zahiri.txt"
KWA = "countries/Kuwaa.txt"
AKA = "countries/Akan.txt"
MDK = "countries/Mandinka.txt"



#Sahara
AGH = "countries/Adagh.txt"
ABL = "countries/Abalessa.txt"
AJJ = "countries/Ajjer.txt"
TED = "countries/Takedda.txt"
GHT = "countries/Ghat.txt"
TRG = "countries/Tuareg.txt"


#Greece
THR = "countries/Thracia.txt"
ATR = "countries/Arta.txt"
TSS = "countries/Thessalonica.txt"
THS = "countries/Thessaly.txt"
CNT = "countries/Corinth.txt"
CPH = "countries/Cephalonia.txt"
#LAT = "countries/LatinEmpire.txt"
LSB = "countries/Lesbos.txt"
CST = "countries/Istinopol.txt"

#Anatolia
CLC = "countries/Cilicia.txt"
ALV = "countries/Alevi.txt"

#Caucasus
ABK = "countries/Abkhazia.txt"
ADY = "countries/Adyghe.txt"
KBD = "countries/Kabardia.txt"
ANI = "countries/Ani.txt"
LKS = "countries/Lak.txt"
SMS = "countries/Simsir.txt"

#Levant
EDD = "countries/Edessa.txt"
TPO = "countries/TripoliC.txt"
ATI = "countries/Antioch.txt"

#Italy
CBR = "countries/Calabria.txt"
MTA = "countries/Matera.txt"
SLR = "countries/Salerno.txt" 
NPI = "countries/Napoli.txt"
TTO = "countries/Tatanto.txt"
APU = "countries/Apuila.txt"
CSE = "countries/Caserta.txt"
BVN = "countries/Benevento.txt"
AZZ = "countries/Abruzzia.txt"
CTN = "countries/Capitanata.txt"
LMB = "countries/Lombardy.txt"
PDN = "countries/Padana.txt"
CRM = "countries/Crema.txt"
CMN = "countries/Cremona.txt"
MSS = "countries/Massa.txt"
ELB = "countries/Elba.txt"
BFZ = "countries/Bunifaziu.txt"
BAS = "countries/Bastia.txt"

#Middle East
SRI = "countries/Sari.txt"
MSL = "countries/Mosul.txt"
TRB = "countries/TurAdbin.txt"
HRT = "countries/Herat.txt"
KMS = "countries/Kirmanshah.txt"
ALM = "countries/Alamut.txt"
SBZ = "countries/Sabzevar.txt"
HAZ = "countries/Hazarajat.txt"
PST = "countries/Pashtunistan.txt"


#North Africa
AFR = "countries/Africa.txt"
DJB = "countries/Djerba.txt"
CYR = "countries/Cyrenaica.txt"
QYW = "countries/Qayrawan.txt"

#India
KNJ = "countries/Kannauj.txt"
SBH = "countries/Sambhal.txt"
LCK = "countries/Lucknow.txt"
BCH = "countries/Bahreich.txt"
CDI = "countries/Chanderi.txt"
CTT = "countries/Chittor.txt"
THA = "countries/Mathura.txt"
PYG = "countries/Prayagraj.txt"
EWH = "countries/Etawah.txt"
RHM = "countries/Ranthambore.txt"
DVI = "countries/Devagiri.txt"

KCP = "countries/Kanchipuram.txt"
CDD = "countries/Cuddalore.txt"
TRQ = "countries/Tranqebar.txt"
NGT = "countries/Negapatam.txt"
KNR = "countries/Kanara.txt"
PNI = "countries/Purnia.txt"
CAA = "countries/Champaran.txt"

#Arabia
ZBD = "countries/Zabid.txt"
SOC = "countries/Socotra.txt"
BHY = "countries/Bahrayn.txt"